########################################
#                                      #
#                                  2   #
#                                      #
#                                      #
#                                      #
#             #################        #
#             #################        #
#             #################        #
#             #################        #
#             #################        #
#             #################        #
#                                      #
#                                      #
#                                      #
#     #########                        #
#     #########                        #
#     #########                        #
#                                      #
#                                      #
#   1                                  #
#                                      #
#                                      #
#                                      #
#                                      #
#                                      #
#                                      #
#                                      #
#                                      #
########################################