########################################
#                                      #
#                                      #
#                 ##                   #
#                 ##                   #
#                 ##                   #
#            ###########               #
#            ###########               #
# 1                                    #
#                                      #
#                                      #
#                                      #
#                                      #
#                                      #
#                                      #
#                                      #
#                 ##                   #
#                 ##                   #
#                 ##                   #
#                 ##                   #
#                 ##                   #
#                 ########             #
#                 ########             #
#                                   2  #
#                                      #
#                                      #
#                                      #
#                                      #
#                                      #
########################################
