########################################
#                                      #
#      ###################             #
#      #                 #             #
#      #                 #             #
#      ###################             #
#                                      #
#               ##########             #
#               #        #             #
#               #        #             #
#               ##########             #
#                                      #
#                     #######          #
#                     #     #          #
#                     #     #          #
#                     #######          #
#                                      #
#    1                                 #
#                                      #
#                                      #
#           #####                      #
#           #   #                      #
#           #   #                      #
#           #####                      #
#                                      #
#                                      #
#                                   2  #
#                                      #
#                                      #
########################################