########################################
#                                      #
#   #######                            #
#   #     #                            #
#   #     #         #######            #
#   #     #         #     #            #
#   #######         #     #            #
#                   #     #            #
#                   #######            #
#  1                                   #
#            #######                   #
#            #     #                   #
#            #     #                   #
#            #     #                   #
#            #######                   #
#                                    2 #
#                   #######            #
#                   #     #            #
#                   #     #            #
#                   #     #            #
#                   #######            #
#                                      #
#                                      #
#       ####                           #
#       ####                           #
#                                      #
#                                      #
#                                      #
#                                      #
########################################