########################################
# 1                                    #
#                 ##                   #
#                 ##                   #
#                 ##                   #
#                 ##                   #
#                 ##                   #
#                 ##                   #
#                 ##                   #
#                 ##                   #
#                 ##                   #
#          #########                   #
#          #########                   #
#                 ##                   #
#                 ##                   #
#                 ######               #
#                 ##                   #
#                 ##                   #
#                 ##                   #
#                 ##                   #
#                 ##                   #
#                 ########             #
#                 ########             #
#                                      #
#                                      #
#                                   2  #
#                                      #
#                                      #
#                                      #
########################################