########################################
#  1                                    #
#  ##############################       #
#  #                            #       #
#  #   ######################   #       #
#  #   #                    #   #       #
#  #   #                    #   #       #
#  #   #                    #   #       #
#  #   ######################   #       #
#  #                            #       #
#  ##############################       #
#                                2     #
#                                      #
#                                      #
#                                      #
#                                      #
#                                      #
#                                      #
#                                      #
#                                      #
#                                      #
#                                      #
#                                      #
#                                      #
#                                      #
#                                      #
#                                      #
#                                      #
#                                      #
########################################