########################################
#  1                                    #
#  #                                   #
#   #                                  #
#    #                                 #
#     #                                #
#      #                               #
#       #                              #
#        #                             #
#         #                            #
#          #                           #
#           #                          #
#            #                         #
#             #                        #
#              #                       #
#               #                      #
#                #                     #
#                 #                    #
#                  #                   #
#                   #                  #
#                    #                 #
#                     #                #
#                      #               #
#                       #              #
#                        #             #
#                         #            #
#                          #           #
#                           #          #
#                                    2 #
########################################