########################################
#                                      #
#        ####                          #
#        #  #                          #
#        #  #      ####                 #
#        ####      #  #                 #
#                 #  #                  #
#                 ####                  #
#                                      #
#                     ######            #
#                     #    #            #
# 1                   #    #           #
#                     ######            #
#                                      #
#              ######                   #
#              #    #                   #
#              #    #                   #
#              ######                   #
#                                      #
#                                      #
#                          ###          #
#                          ###          #
#                          ###          #
#                                      #
#                                      #
#                                    2 #
#                                      #
#                                      #
#                                      #
########################################