########################################
#                                      #
#         ###                          #
#         ###                          #
#         ###                          #
#                                      #
#              ######                  #
#              #    #                  #
#              ######                  #
#  1                                   #
#                     ####             #
#                     #  #             #
#                     ####             #
#                                      #
#                          #####       #
#                          #   #       #
#                          #####       #
#                                      #
#               ##                     #
#               ##                     #
#                                      #
#       ####                            #
#       #  #                            #
#       ####                            #
#                                      #
#                                    2 #
#                                      #
#                                      #
########################################