########################################
#                                      #
#         ########                     #
#         #      #                     #
#         #      #                     #
#         #      #                     #
#         ########                     #
#                                   2  #
#               ###########            #
#               #         #            #
#               #         #            #
#               #         #            #
#               ###########            #
#                                      #
#                     ######           #
#                     #    #           #
#                     #    #           #
#                     ######           #
#                                      #
#  1                                   #
#                         ####         #
#                         #  #         #
#                         #  #         #
#                         ####         #
#                                      #
#                                      #
#                                      #
#                                      #
#                                      #
########################################